11111111111111111111111111111111111111111111111111111111111111111111111          1111
1d        1m         11t  1u 1   1c          b              1a     1p               1
1         1          11   1  1   1          1               1      1                1
1         1          11   1  1   1                          1      1                1
1         1          11   1  1   1          1               1      1                1
1    L    1     L    11   1L 1 L 1     L            L       1  L   1   L        L   1
1         1          11   1  1   1          1               1      1                1
1         1          11   1  1   1                          1      1                1
1         1          11   1  1   1          1               1      1                1
1         1          113  1  1   1                          1      1   L        L   1
111111  11111111  111111  1  1  111111  1111111111  1111111111  1111                1
1o                                                                 1                1
1                                                                  1                1
      L        L       L       L          L          L        L                     1
                                                                            112221111
1                                                                  1q       1r      1
1                                                                  1        1       1
111111  11111  1111  111111  1111111111  111111  111111  11111  1111            L   1
1e         1f   1g     1h      1i           j      1k      1n      1                1
1          1    1      1       1           1       1       1       1   L    1       1
1          1    1      1       1                   1       1       1        1       1
1          1    1      1       1           1       1       1       1        111111111
1    L     1    1  L   1   L   1     L         L   1   L   1   L   11  1    1s      1
1          1    1      1       1           1       1       1       11  1            1
1          1    1      1       1                   1       1       11  1     4      1
1          1    1      1       1           1       1       1       11  1            1
1          1    1      1       1                   1       1       11111    111111111
1111111111111111111111111111111111111111111111111111111111111111111111111111111111111