1122221222111122111221112211111111111111111111111111111111111111111111111111111111111
1J         1I    1H   1G  11F   1E   1D         1C        1B       1U   1A          1
1          1     1    1   11    1    1          1         1        1    1           1
1          1     1    1   11    1    1          1         1        1    1           1
1          1     1    1   11    1    1          1         1        1    1           1
1    L     1  L  1 L  1 L 11 L  1 L  1    L     1    L    1   L    1 L  1      L    1
1          1     1    1   11    1    1          1         1        1    1           1
1          1     1    1   11    1    1          1         1        1    1           1
1          1     1    1   11    1    1          1         1        1    1           1
1          1     1    1   11    1    1          1         1        113 113 1111111111
1          1113 113 111  1113 1113 11111113 1111111113 11111113 1111S       Q       1
1          1R                                                      1           L    1
1          1                                                       1       1        1
      L        L       L       L          L          L        L            1111111111
                                                                           1P       1
1          1                                                       1           L    1
1          1                                                       1                1
1          1111111 411111111111111111111 4111111111111111 4111111 41       1        1
1          1K                 M                      1N       1O   1   L   1111111111
1          1                 1                       1        1    1       1T       1
1          1                                         1        1    1       1        1
1          1                 1                       1        1    11 41   1        1
1    L     1        L                   L            1    L   1    11  1   1111111111
1          1                 1                       1        111  11  1    5  L    1
1          1                                         1        1    11  1    5       1
1          1                 1                       1        1    11  1   11       1
1          1                                         1        1    11111   1111111111
1111111111111111111111111111111111111111111111111111111111111111111111111111111111111