g.g.g.g.g
E.E.E.E.E
.........
g.g...g.g
E.E...E.E
.........
g.....g.g
E.....E.E
.........