gg..gg..gg
EE..EE..EE
..........
gg......gg
EE......EE
..........
..........
ee......ee
GG......GG