.a....a.
b......B
........
jH....hJ
........
b......B
........
jH....hJ
........