.................
.e.e.....e.e.e.e.
.G.G.....G.G.G.G.
.................
.g.g.....g.g.g.g.
.E.E.....E.E.E.E.
.................
eee.eeee.eeee.eee
GGG.GGGG.GGGG.GGG