.......................
eee..eee...............
GGG..GGG...............
.......................
...............eee..eee
...............GGG..GGG
.......................
eee..eee...............
GGG..GGG...............