bb..bb..bb
AA..AA..AA
..........
bb......bb
AA......AA
..........
..........
aa......aa
BB......BB