........
......e.
......G.
........
.....eee
.....GGG
eee.....
GGG.....
........