.......................
aaa..aaa...............
BBB..BBB...............
.......................
...............aaa..aaa
...............BBB..BBB
.......................
aaa..aaa...............
BBB..BBB...............