11111111111111111111111555511111111111111111111111111111111111111111111          1111
1d        1m         150005  1   1c          b              1a     1                1
1         1          150005  1   1          1               1      1                1
1         1          150005  1   1                          1      1                1
1         1          150005  1   1          1               1      1                1
1    L    1     L    150005  1   1                          1      1                1
1         1          150005  1   1          1               1      1                1
1         1          150005  1   1                          1      1                1
1         1          150005  1   1          1               1      1                1
1         1          153005  1   1                          1      1                1
111111  11111111  111111  1  1  111111  1111111111  1111111111  1111                1
1                                                                  1                1
1                                                                  1                1
      L        L       L       L          L          L        L                     1
                                                                            112221111
1                                                                  1        1       1
1                                                                  1        1       1
111111  11111  1111  111111  1111111111  111111  111111  11111  1111                1
1e         1f   1g     1h      1i           j      1k      1l      1                1
1          1    1      1       1           1       1       1       1        1       1
1          1    1      1       1                   1       1       1        1       1
1          1    1      1       1           1       1       1       1        111111111
1    L     1    1      1       1                   1       1       11  1    1       1
1          1    1      1       1           1       1       1       11  1     00000005
1          1    1      1       1                   1       1       11  1     40000005
1          1    1      1       1           1       1       1       11  1     00000005
1          1    1      1       1                   1       1       11111    1       1
1111111111111111111111111111111111111111111111111111111111111111111111111111111111111