1122221222111122111221112211111111111111111111111111111111111111111111111111111111111
1J         1I    1H   1G   1F   1E   1D         1C        1B       1    1A          1
1          1     1    1    1    1    1          1         1        1    1           1
1          1     1    1    1    1    1          1         1        1    1           1
1          1     1    1    1    1    1          1         1        1    1           1
1    L     1  L  1 L  1 L  1 L  1 L  1    L     1    L    1   L    1 L  1      L    1
1          1     1    1    1    1    1          1         1        1    1           1
1          1     1    1    1    1    1          1         1        1    1           1
1          1     1    1    1    1    1          1         1        1    1           1
1          1     1    1    1    1    1          1         1        11  11  1111111111
1          111  11  111  111  111  1111111  111111111  1111111  1111        P       1
1          1                                                       1           L    1
1          1                                                       1       1        1
      L        L       L       L          L          L        L            1111111111
                                                                           1O       1
1          1                                                       1           L    1
1          1                                                       1                1
1          1111111  11111111111111111111  111111111111111  111111  1       1        1
1          1K                 L                      1M       1N   1       1111111111
1          1                 1                       1        1    1       1        1
1          1                                         1        1    1       1        1
1          1                 1                       1        1    11  1   1        1
1    L     1        L                   L            1    L   1    11  1       L    1
1          1                 1                       1        111  11  1            1
1          1                                         1        1    11  1   1        1
1          1                 1                       1        1    11  1   1        1
1          1                                         1        1    11111   1        1
1111111111111111111111111111111111111111111111111111111111111111111111111111111111111