.................
.a.a.....a.a.a.a.
.B.B.....B.B.B.B.
.................
.b.b.....b.b.b.b.
.A.A.....A.A.A.A.
.................
aaa.aaaa.aaaa.aaa
BBB.BBBB.BBBB.BBB