b.b..b.b
A.A..A.A
........
b.b..b.b
A.A..A.A
........
b.b..b.b
A.A..A.A
........