........
......a.
......B.
........
.....aaa
.....BBB
aaa.....
BBB.....
........